NO
SO
WE
EA

C 200,230,255
F 172,38,38

11111111111
10000000001
1000N000001
10000000001
10000000001
10000000001
10000000001
10000000001
11111111111