NO
SO
WE
EA

C 200,230,255
F 80,60,30

        11111111111
    11110000001
    10000001111  1
11110000001     101
10000N00001     101
10000000001     111
10000000001
10000000001
11111111111      1