NO ./textures/wall_2_1.xpm
SO ./textures/wall_2_2.xpm
WE ./textures/wall_2_3.xpm
EA ./textures/wall_2_4.xpm

C 200,230,255
F 80,60,30

        1111111111111111111111111
        1000000000110000000000001
        1011000001110000000000001
        1001000000000000000000001
111111111011000001110000111110001
100000000011000001110101111111111
11110111111111011100000010001
11110111111111011101010010001
10000000110101011100000010001
100W0000000000001100000010001
10000001110000011110100100001
11110111 1110101 101111010011
11111111 1111111 111111111111